DDDDDDDDDDDDDDDDDDDDDDDDDDDDDDDDDDDDDDDDDDDDDDDDDDDDDDDDDDDD
DGGGGGGGGGGGGGGGGGGGGGGGGGGGD3DGGGGGGGGGGGGGGGGGGGGGGGGGGGGD
DGGGGGGCGGGGGGGGGGGGGGGGGGGGpPpGHGGGGGGGGGGGGGGGGGGGGGGGGGGD
DGGGGGGGGGGGGGGGGGGGGGGGGGGGpPpGGGGGGGGGGGGGGGGGGGGGGGGGGGGD
DGGGGGGGGGGGCGGGGGGCGGGGGGGGpPpGGGGGGGCGGGGGGGGGGGGCGGGGGGGD
DGGGGGGCGGGGGGGGGGGGCCGGGGGGpPpGGGGGGGGGGGGGGGGGGGGCCGGGGGGD
DGGGGGGGGGGGGGGGGGGGGGGGGGGGpPpGGGGGGGGGGGGGGGGGGGGGGGGGGGGD
DGGGGGGGCCGGGGGGGGGGGCGGGGGGpPpGGGGGGGGGGCGGGGGGGGGGGGGGGGGD
DGGGGGGGGGGGGGGGGGGGGGGGGGGGpPpGGGGGGGGGGGGGGGGGGGGGGGGGGGGD
DGGGGGGGGGGGGGCGGGGGGGGGGGGGpPpGGGGGGGGGGCGGGGGGGGGGGGGGGGGD
DGGGGCCGGGGGGGGGGGGGGGGGGGGGpPpGGGGGGGGGGGGGGGGGGGGGCGGGGGGD
DGGGGGGGGGGGGGGGGGGGGGGGGGGGpPpGGGGGGGGGGGGGGGGGGGGGGGGGGGGD
DGGGGGCGGGGGGCGGGGGGGGGGGGGGpPpGGGGHGGGGGGGGGGGGGGGGGGGGGGGD
DGGGGGGGGGGGGGGGGGGGGCGGGGGGpPpGGGCCGGGGGGCCCCCGGGGGGGGGGGGD
DGGGGGCCCSGGGGGGGGGGGGGGGGGGpPpGGGGGGGGGGGGGGGGGGGGGGGGGGGGD
DDppppppppppppppppppppppppppPPPpppppppppppppppppppppppppppDD
D1PPPPPPPPPPPPPPPPPPPPPPPPPPPSPPPPPPPPPPPPPPPPPPPPPPPPPPPP2D
DDppppppppppppppppppppppppppPPPpppppppppppppppppppppppppppDD
DGGGGiGGGGGGGkGGGGGGGGGGFGGGpPpGGGGGGGGGGGGGGGGGGGGGGGGGGGGD
DGGGGijjjjjjjkGGGGGGGGGGGGGGpPpGGGGGGGCGGGGGGGGGGGGGGGGGGGGD
DGGGNMMMMMMMMMGGGGGGGGGGGGGGpPpGGGCCGGGGGGGGGGGGCGGGGGGGGGGD
DGGGGGGGGGGGGGGGGGGGGGGGGCGGpPpGGGGGGGGGGGGGGGGGGGGCGGGGGGGD
DGGGGGGGGCGGGGGGGGGGGGGGGGGGpPpGGGGGGGGGGGGGGGGGGGGGGGGGGGGD
DGGGGGGGGGGGGGGGGGGGGGGGGGCGpPpGGGGCGGGGGGGGGGGGGGGGGGGGGGGD
DGGGGCGGGGGGGGGGGGCGGGGGGGGGpPpGGGGGGGGGGCGGGGGGGGGGGGGGGGGD
DGGGGGGGGGGGGGGGGGGGGGGGGGGGpPpGGGGGGGGGGGGGGGGGGGGGGGGGGGGD
DGGGGGGGGCGGGGGGGGGGGGGGGGGGpPpGGGGGGGGGGGGGGGGGGGGGGGGGGGGD
DGGGGGGGGGGGGGGGGGGGCGGGGGGGpPpGGGGGGCGGGGGGGGGGGGGGGGGGGGGD
DGGGGGGGGGGGGGGGGGGGGGGGCGGGpPpGGGCGGGGGGGGGGGGGGGGCGGGGGGGD
DGGGGGGGGGGGGGGGGGGGGGGGGCCGpPpGCCGGGGGGGGGGGGGGGGGGGGGGGGGD
DGGGGGGGGGGGCGGGGGGGGGGGGGCGpPpGCGGGGCGGGGGGGGGGGGGGGGGGGGGD
DGGGGGGGGGGGGGGGGGGGGGGGGGCGpPpGCGGGGGGGGGGGGGGGGGGGGGGGGGGD
DDDDDDDDDDDDDDDDDDDDDDDDDDDDDDDDDDDDDDDDDDDDDDDDDDDDDDDDDDDD