DDDDDDDDDDDDDDDDDDDDDDDDDDDDDDDDDDDDDDDDDDDDDDDDDDDDDDDDDDDD
DGGGGGGGGGGGGGGGGGGGGGGGGGGGGGGGGGGGGGGGGGGGGGGGGGGGGGGGGGGD
DGGGGGCCCGGGGGGGGGGGGGGGGGGGGGGGHGGGGGGGGGGGGGGGGGGGGGGGGGGD
DGGGGGGGCGGGGGGGGGGGGGGGGGGGGGGGGGGGGGGGGGGGGGGGCGGGGGGGGGGD
DGGGGGGGCGGGCGGGGGGCGGGGGGGGGGGGGGGGGGCGGGGGGGGGGGGGGGGGGGGD
DGGGGGGGCGGGGGGGGGGGCCGGGGGGGGGGGGGGGGGGGGGGGGGGGGGGGGGGGGGD
DGGGGGGGGGGGGGGGGGGGGGGGGGGGGGGGGGGGGGGGGGGGGGGGGGGGGGGGGGGD
DGGGGGGGCCGGGGGGGGGGGGGGGGGGGGGGGGGGGGGGGGCCCCCGGGGGGGGGGGGD
DGGGGGGGGGGGGGGGGGGGGGGGGGGGGGGGGGGGGGGGGGGGGGGGGGGGGGGGGGGD
DGGGGGGGGGGGGGCGGGGGGGGGGGGGGCCCGGGGGGGGGGGGGGGGGGGGGGGGGGGD
DGGGGCCGGGGGGGGGGGGGGGGGGGGGGGGGGGGGGGGGGGGGGGGGGGGGGGGGGGGD
DGGGGGGGGGGGGGGGGGGGGGGGGGGGGGGCGGGGGGGGGGGGGGGGGGGGGGGGGGGD
DGGGGGCGGGGGGCGGGGGGGGGGGGGGGGGGGGGHGGGGGGGGGGGGGGGGGGGGGGGD
DGGGGGGGGGGGGGGGGGGGGCGGGGGGGGGGGGGGGGGGGGCCCCCGGGGGGGGGGGGD
DGGGGGCCCSGGGGGGGGGGGCGGGGGGGGGGGGGGGGGGGGGGGGGGGGGGGGGGGGGD
DGGGGGGGGGGGGGGGGGGGGGGGGGGGGGGGGGGGGGGGGGGGGGGGGGGGGGGppppD
DGGGGGGGGGGGGGGGGGGGGGGGGGGGGGGGGGGGGGCGGGGGGGGGGGGGGGGPPP0D
DGGGGGGGGGGGGCGGGGGGGGGGGGGGGGGGGGGGGGGGGGGGGGGGGGGGGGGppppD
DGGGGiGGGGGGGkGGGGGGGCGGFGGGGGGGGGGGGGGGGGGGGGGGGGGGGGGGGGGD
DGGGGijjjjjjjkGGGGGGGGGGGGGGGGGGGGGGGGCGGGGGGGGGGGGGGGGGGGGD
DGGGNMMMMMMMMGGGGGGGGGGGGGGGGGGGGCGGGGGGGGGGGGGGGGGGGGGGGGGD
DGGGGGGGGGGGGGGGGGGGGGGGGGGGGGGGGGGGGGGGGGGGGGGGGGGCGGGGGGGD
DGGGGGGGGCGGGGGGGGGGGCGGGGGGGGGGGGGGGGGGGGGGGGGGGGGGGGGGGGGD
DGGGGGGGGGGGGGGGGGGGGGGGGGGGGGGGGGGGGGGGGGGGGGGGGGGGGGGGGGGD
DGGGGCGGGGGGGGGGGGCGGGGGGGGGGCCGGGGGGGGGGCGGGGGGGGGGGGGGGGGD
DGGGGGGGGGGGGGGGGGGGGGGGGGGGGGGGGGGGGGGGGGGGGGGGGGCGGGGGGGGD
DGGGGGGGGGGGGGGGGGGGGGGGGGGGGGGGGGGGGGGGGGGGGGGGGGGGGGGGGGGD
DGGGGGGGGGGGGGGGGGGGCGGGGGGGGGGGGGGGGGGGGGGGGGGGGGGGGGGGGGGD
DGGGGGGGGGGGGGGGGGGGGGGGGGGGGGGGGGGGGGGGGGGGGGGGGGGCGGGGGGGD
DGGGGGGGGGGGGCGGGGGGGGGGGGGGGGGGGGGGGGGGGGGGGGGGGGGGGGGGGGGD
DGGGGGGGGGGGGGGGGGGGGGGGGGGGGGGGGGGGGCGGGGGGGGGGGGGGGGGGGGGD
DGGGGGGGGGGGGGGGGGGGGGGGGGGGGGGGGGGGGGGGGGGGGGGGGGGGGGGGGGGD
DDDDDDDDDDDDDDDDDDDDDDDDDDDDDDDDDDDDDDDDDDDDDDDDDDDDDDDDDDDD
